1111111111111
1000000C000CO
10010000000C1
1000011111001
1P0011E000001
111111111111X