1111111011111
1000000C000C1
1001000000C1
1000011111001
1P0011E0000o1
1111111111111