1111111111111111111
1E000000C000010C001
101001010010C000101
1010010000101010001
1P0000100C00C000101
1111111111111111111
