1111111111111111111
1E000000C000010C001
101001010010C000101
1C10010P00101010001
100000100C00C000101
1111111111111111111
