1111111111
1E00000001
100C000001
1010000P01
1111111111
